ACTION	AE K SH AH N
ADENINE	AE D EH N IY N
ALANINE	AE L AE N IY N
ALIPHATIC	AH L IH P HH AE T IH K
AMINOACID	AH M IY N OW AE S AH D
ANALYTICAL_COMPONENT	AE N AH L IH T IH K AH L K AH M P OW N AH N T
ANION	AE N AY AH N
AREA	EH R IY AH
ARGININE     	AA R JH AH N IY N
AROMATIC	EH R AH M AE T IH K
ASPARTIC ACID	AE S P AE R T IH K AE S AH D
ATOM	AE T AH M
ATOM_ID	AE T AH M AY D IH
ATTRIBUTE	AH T R IH B Y UW T
AXIS	AE K S AH S
B-FACTOR	B IY F AE K T ER
BIOLOGICAL_COMPONENT	B AY AH L AA JH IH K AH L K AH M P OW N AH N T
BIOPHYSICAL_PROPERTY	B AY AH F IH Z IH K AH L P R AA P ER T IY
BLACK	B L AE K
BLUE	B L UW
CARTOON	K AA R T UW N
CATION	K EY SH AH N
CHAIN	CH EY N
CHARGE	CH AA R JH
COLOR	K AH L ER
COLOR(2)	K AO L ER
COLORS	K AH L ER Z
CYAN	S AY AE N
CYSTEINE     	S IY S T EH IY N
CYTOSINE	S AY T AH S IY N
DNA	D IY EH N EY
EXPERIMENTAL_PROPERTY	IH K S P EH R IH M EH N T AH L P R AA P ER T IY
GEOMETRICAL_PROPERTY	JH IY AH M EH T R IH K AH L P R AA P ER T IY
GLUTAMINE	G L UW T AE M IH N AH
GLUTAMIC_ACID	G L UW T AE M IY K AE S AH D
GLYCINE	G L AY S IH N
GRAPHIC	G R AE F IH K
GREEN	G R IY N
GUANINE	G W AE N IH N
HIDE	HH AY D
HIGHLIGHT	HH AY L AY T
HISTIDINE	HH IH S T IH D IH N
HISTOGRAM	HH IH S T AH G R AE M
HYDROPHILIC	HH AY D R AH F IH L IH K
HYDROPHOBIC	HH AY D R AH F OW B IH K
HYDROPHOBICITY	HH AY D R AH F OW B IH S IH T IH
IDENTIFIER	AY D EH N T AH F AY ER
ION	AY AA N
ISOLEUCINE	AY S O L AH S IH N
LARGE	L AA R JH
LEUCINE L AH S IH N
LIGAND	L IH G AH N D
LINES	L AY N Z
LINE_PLOT	L AY N P L AA T
LYSINE  L AY S IH N
MAGENTA	M AH JH EH N T AH
MEMBRANE	M EH M B R EY N
METHIONINE	M AH TH IY AH N AY N 
MODEL	M AA D AH L
MOLECULE	M AA L AH K Y UW L
NEGATIVE	N EH G AH T IH V
NEUTRAL	N UW T R AH L
NON	N AA N
NUCLEOTID	N AH K L IY AH T AH D
OBJECT	AA B JH EH K T
OBJECT(2)	AH B JH EH K T
PHARMACOPHORE	F AA R M AE K AH F AH R
PHENYLALANINE	F AH N IH L AE L AH N IH N
PIE	P AY
POINT	P OY N T
POLAR	P OW L ER
POLARITY	P OW L EH R AH T IY
POSITION	P AH Z IH SH AH N
POSITIVE	P AA Z AH T IH V
PRIMARY_STRUCTURE	P R AY M EH R IY S T R AH K CH ER
PROLINE P R OW L IH N
PROPERTY	P R AA P ER T IY
PROTEIN	P R OW T IY N
RADIUS	R EY D IY AH S
RED	R EH D
REPRESENTATION	R EH P R AH Z EH N T EY SH AH N
RES_ID	R EY Z AY D
RESIDUE	R EH Z IH D UW
RIBBON	R IH B AH N
SCATTER_PLOT	S K AE T ER P L AA T
SECONDARY_STRUCTURE	S EH K AH N D EH R IY S T R AH K CH ER
SELECT	S AH L EH K T
SELECTION	S AH L EH K SH AH N
SERINE  S AH R IH N
SHORTNAME	SH AO R T N EY M
SHOW	SH OW
SIZE	S AY Z
SMALL	S M AO L
SOLVENT	S AA L V AH N T
STICKS	S T IH K S
STRUCTURE	S T R AH K CH ER
SURFACE	S ER F AH S
TERTIARY_STRUCTURE	T ER SH ER IY S T R AH K CH ER
THREONINE	TH R IY AH N IH N
THYMINE	TH AH M AY N
TINY	T AY N IY
TRYPTOPHANE	T R IH P T AH F AE N
TYROSINE	T AY R AH ZH IH N
URACILE	Y UH R AH S AH L
VALUE	V AE L Y UW
VALINE  V AE L IH N
VDW	V IY D IY W
VISUAL_PROPERTY	V IH ZH AH W AH L P R AA P ER T IY
VISUAL_REPRESENTATION	V IH ZH AH W AH L R EH P R AH Z EH N T EY SH AH N
WATER	W AO T ER
WHITE	W AY T
WHITE(2)	HH W AY T
X	EH K S
Y	W AY
YELLOW	Y EH L OW
Z	Z IY
